"state_name","current_year","current_quarter","current_tx","previous_tx","growth","growth_percent"
"odisha",2018,3,"30052155","8158144","21894011","268.37"
"west-bengal",2018,3,"53705416","18082446","35622970","197.00"
"jammu-&-kashmir",2020,2,"2635006","921630","1713376","185.91"
"lakshadweep",2018,2,"2132","778","1354","174.04"
"jharkhand",2018,3,"8122621","3152080","4970541","157.69"
"ladakh",2018,2,"15010","6089","8921","146.51"
"manipur",2023,4,"2113200","865478","1247722","144.17"
"telangana",2019,1,"65290702","28921154","36369548","125.75"
"meghalaya",2022,3,"4359165","2044649","2314516","113.20"
"rajasthan",2019,1,"43956040","20959723","22996317","109.72"
"andhra-pradesh",2018,3,"25626061","12353918","13272143","107.43"
"goa",2020,4,"3801381","1915531","1885850","98.45"
"delhi",2018,3,"18547048","9373723","9173325","97.86"
"karnataka",2019,1,"86587609","44812071","41775538","93.22"
"andaman-&-nicobar-islands",2020,4,"224531","117483","107048","91.12"
"jammu-&-kashmir",2018,2,"1796326","941568","854758","90.78"
"jammu-&-kashmir",2020,1,"921630","489928","431702","88.12"
"ladakh",2023,2,"2943815","1567246","1376569","87.83"
"andaman-&-nicobar-islands",2020,3,"117483","62962","54521","86.59"
"andhra-pradesh",2019,1,"57264522","30759548","26504974","86.17"
"manipur",2020,1,"818801","449344","369457","82.22"
"manipur",2024,1,"3845564","2113200","1732364","81.98"
"arunachal-pradesh",2018,2,"82157","45497","36660","80.58"
"manipur",2018,2,"151721","84069","67652","80.47"
"telangana",2018,3,"19332703","10764670","8568033","79.59"
"ladakh",2024,2,"5327359","2987101","2340258","78.35"
"ladakh",2022,2,"1118073","630015","488058","77.47"
"tripura",2018,3,"377703","214559","163144","76.04"
"uttarakhand",2019,1,"5546001","3178761","2367240","74.47"
"madhya-pradesh",2019,1,"37301049","21397555","15903494","74.32"
"arunachal-pradesh",2023,1,"8042825","4632709","3410116","73.61"
"karnataka",2018,4,"44812071","25980261","18831810","72.49"
"lakshadweep",2023,1,"29520","17147","12373","72.16"
"goa",2021,4,"11088759","6467763","4620996","71.45"
"haryana",2019,1,"22135775","12950183","9185592","70.93"
"andaman-&-nicobar-islands",2018,2,"11340","6658","4682","70.32"
"gujarat",2019,1,"24991451","14733303","10258148","69.63"
"sikkim",2018,2,"74578","44078","30500","69.20"
"bihar",2019,1,"26356234","15732401","10623833","67.53"
"puducherry",2020,3,"1730902","1033383","697519","67.50"
"bihar",2018,3,"14367804","8632378","5735426","66.44"
"jammu-&-kashmir",2020,4,"5754444","3465898","2288546","66.03"
"andhra-pradesh",2023,1,"1145532464","690017077","455515387","66.02"
"himachal-pradesh",2019,1,"2168718","1307883","860835","65.82"
"ladakh",2018,3,"24864","15010","9854","65.65"
"dadra-&-nagar-haveli-&-daman-&-diu",2023,1,"11803985","7189585","4614400","64.18"
"dadra-&-nagar-haveli-&-daman-&-diu",2019,1,"661814","404082","257732","63.78"
"maharashtra",2019,1,"75079069","46090223","28988846","62.90"
"puducherry",2019,1,"501092","307964","193128","62.71"
"meghalaya",2018,3,"110290","67857","42433","62.53"
"madhya-pradesh",2018,3,"17126985","10561412","6565573","62.17"
"puducherry",2018,4,"307964","190271","117693","61.86"
"sikkim",2019,2,"388244","240287","147957","61.58"
"delhi",2019,1,"47007327","29187719","17819608","61.05"
"odisha",2019,1,"34031942","21142798","12889144","60.96"
"dadra-&-nagar-haveli-&-daman-&-diu",2020,4,"1817791","1138312","679479","59.69"
"arunachal-pradesh",2018,3,"131146","82157","48989","59.63"
"uttar-pradesh",2019,1,"57324504","36100767","21223737","58.79"
"assam",2018,4,"3734172","2351851","1382321","58.78"
"tamil-nadu",2020,4,"111179701","70277825","40901876","58.20"
"tamil-nadu",2018,3,"15774078","9992128","5781950","57.87"
"assam",2018,2,"1663873","1056881","606992","57.43"
"delhi",2018,4,"29187719","18547048","10640671","57.37"
"odisha",2019,4,"64995633","41422272","23573361","56.91"
"puducherry",2020,4,"2716003","1730902","985101","56.91"
"haryana",2018,4,"12950183","8262024","4688159","56.74"
"sikkim",2019,1,"240287","154533","85754","55.49"
"telangana",2020,3,"236372126","152055143","84316983","55.45"
"west-bengal",2018,2,"18082446","11710225","6372221","54.42"
"nagaland",2018,2,"65599","42845","22754","53.11"
"telangana",2022,3,"1628165401","1063382557","564782844","53.11"
"kerala",2020,4,"33288187","21758680","11529507","52.99"
"andaman-&-nicobar-islands",2020,2,"62962","41298","21664","52.46"
"maharashtra",2020,4,"407621004","268310924","139310080","51.92"
"karnataka",2018,3,"25980261","17116447","8863814","51.79"
"mizoram",2023,1,"1052595","693774","358821","51.72"
"goa",2018,4,"514755","339511","175244","51.62"
"lakshadweep",2019,1,"2481","1642","839","51.10"
"chandigarh",2021,3,"6649378","4417547","2231831","50.52"
"kerala",2019,1,"6469039","4310654","2158385","50.07"
"uttar-pradesh",2018,3,"26515356","17710943","8804413","49.71"
"telangana",2018,4,"28921154","19332703","9588451","49.60"
"jharkhand",2019,1,"9387708","6284043","3103665","49.39"
"ladakh",2019,2,"68772","46145","22627","49.03"
"uttarakhand",2020,4,"17613271","11818935","5794336","49.03"
"chhattisgarh",2018,2,"2816156","1891514","924642","48.88"
"tamil-nadu",2018,2,"9992128","6726622","3265506","48.55"
"bihar",2018,2,"8632378","5824302","2808076","48.21"
"karnataka",2019,3,"170733735","115401604","55332131","47.95"
"andaman-&-nicobar-islands",2022,3,"1584379","1071217","513162","47.90"
"goa",2018,3,"339511","229575","109936","47.89"
"ladakh",2021,3,"590987","399716","191271","47.85"
"nagaland",2018,4,"139333","94371","44962","47.64"
"himachal-pradesh",2018,4,"1307883","886754","421129","47.49"
"dadra-&-nagar-haveli-&-daman-&-diu",2021,3,"3129470","2125083","1004387","47.26"
"ladakh",2020,3,"228222","155010","73212","47.23"
"chhattisgarh",2020,4,"35529636","24148539","11381097","47.13"
"maharashtra",2019,3,"148735581","101149853","47585728","47.04"
"rajasthan",2018,4,"20959723","14257098","6702625","47.01"
"chhattisgarh",2019,1,"7887669","5365844","2521825","47.00"
"punjab",2019,1,"7172137","4887137","2285000","46.76"
"chandigarh",2018,4,"905116","616936","288180","46.71"
"jammu-&-kashmir",2022,2,"23813747","16245311","7568436","46.59"
"gujarat",2018,3,"11334149","7745733","3588416","46.33"
"rajasthan",2020,3,"149088676","101954656","47134020","46.23"
"maharashtra",2018,4,"46090223","31538538","14551685","46.14"
"delhi",2020,3,"96491861","66042018","30449843","46.11"
"meghalaya",2018,4,"161132","110290","50842","46.10"
"andaman-&-nicobar-islands",2018,4,"23758","16265","7493","46.07"
"puducherry",2018,3,"190271","130261","60010","46.07"
"mizoram",2018,2,"27051","18561","8490","45.74"
"west-bengal",2019,4,"96805838","66444829","30361009","45.69"
"jharkhand",2020,4,"39431633","27068473","12363160","45.67"
"ladakh",2020,4,"332134","228222","103912","45.53"
"sikkim",2018,3,"108500","74578","33922","45.49"
"telangana",2020,4,"343643787","236372126","107271661","45.38"
"mizoram",2018,3,"39316","27051","12265","45.34"
"maharashtra",2020,3,"268310924","184790761","83520163","45.20"
"ladakh",2021,2,"399716","275415","124301","45.13"
"lakshadweep",2023,4,"63479","43757","19722","45.07"
"tripura",2018,2,"214559","148157","66402","44.82"
"ladakh",2023,1,"1567246","1083372","483874","44.66"
"jharkhand",2018,2,"3152080","2178921","973159","44.66"
"lakshadweep",2024,3,"157478","109085","48393","44.36"
"jammu-&-kashmir",2024,2,"108179014","75116355","33062659","44.02"
"nagaland",2018,3,"94371","65599","28772","43.86"
"chhattisgarh",2021,3,"64237938","44689420","19548518","43.74"
"tamil-nadu",2019,1,"32275045","22457444","9817601","43.72"
"karnataka",2020,4,"431536984","300360531","131176453","43.67"
"haryana",2020,4,"83171439","57938179","25233260","43.55"
"goa",2019,1,"738812","514755","224057","43.53"
"andaman-&-nicobar-islands",2018,3,"16265","11340","4925","43.43"
"jammu-&-kashmir",2021,2,"10027819","6997570","3030249","43.30"
"arunachal-pradesh",2019,3,"370234","258656","111578","43.14"
"rajasthan",2018,3,"14257098","9973697","4283401","42.95"
"dadra-&-nagar-haveli-&-daman-&-diu",2018,3,"289575","202626","86949","42.91"
"himachal-pradesh",2018,2,"687695","481918","205777","42.70"
"goa",2018,2,"229575","160897","68678","42.68"
"uttarakhand",2018,4,"3178761","2229132","949629","42.60"
"arunachal-pradesh",2020,2,"808774","567175","241599","42.60"
"jammu-&-kashmir",2023,1,"38927244","27316158","11611086","42.51"
"karnataka",2018,2,"17116447","12016899","5099548","42.44"
"sikkim",2018,4,"154533","108500","46033","42.43"
"tamil-nadu",2018,4,"22457444","15774078","6683366","42.37"
"sikkim",2019,3,"552436","388244","164192","42.29"
"nagaland",2020,3,"736319","517566","218753","42.27"
"madhya-pradesh",2020,3,"108579881","76340573","32239308","42.23"
"goa",2019,3,"1092416","768441","323975","42.16"
"karnataka",2021,3,"753296539","530649046","222647493","41.96"
"ladakh",2018,4,"35211","24864","10347","41.61"
"maharashtra",2018,3,"31538538","22285740","9252798","41.52"
"manipur",2021,1,"2303535","1627852","675683","41.51"
"madhya-pradesh",2020,4,"153652541","108579881","45072660","41.51"
"andaman-&-nicobar-islands",2021,4,"636123","449764","186359","41.43"
"andhra-pradesh",2020,3,"204902935","144917855","59985080","41.39"
"assam",2018,3,"2351851","1663873","687978","41.35"
"west-bengal",2019,3,"66444829","47023535","19421294","41.30"
"puducherry",2019,4,"1012655","716826","295829","41.27"
"uttar-pradesh",2018,2,"17710943","12537805","5173138","41.26"
"chandigarh",2020,3,"2158086","1528010","630076","41.24"
"punjab",2018,4,"4887137","3462108","1425029","41.16"
"karnataka",2020,3,"300360531","213221712","87138819","40.87"
"chandigarh",2019,1,"1274476","905116","369360","40.81"
"goa",2023,1,"24195070","17192674","7002396","40.73"
"andhra-pradesh",2019,4,"107218103","76288614","30929489","40.54"
"mizoram",2018,4,"55242","39316","15926","40.51"
"odisha",2018,2,"8158144","5809821","2348323","40.42"
"jharkhand",2019,3,"14220647","10128211","4092436","40.41"
"odisha",2019,3,"41422272","29512024","11910248","40.36"
"delhi",2021,3,"238760608","170157264","68603344","40.32"
"goa",2021,1,"5331549","3801381","1530168","40.25"
"jammu-&-kashmir",2023,2,"54588299","38927244","15661055","40.23"
"lakshadweep",2020,2,"7220","5151","2069","40.17"
"uttar-pradesh",2020,4,"178167517","127405259","50762258","39.84"
"tamil-nadu",2021,3,"204357404","146158442","58198962","39.82"
"odisha",2020,4,"92324950","66033829","26291121","39.81"
"andhra-pradesh",2020,4,"286118552","204902935","81215617","39.64"
"dadra-&-nagar-haveli-&-daman-&-diu",2018,4,"404082","289575","114507","39.54"
"andaman-&-nicobar-islands",2021,2,"341414","244752","96662","39.49"
"madhya-pradesh",2021,3,"311443334","223314680","88128654","39.46"
"karnataka",2019,4,"237796252","170733735","67062517","39.28"
"rajasthan",2021,3,"400284753","287477039","112807714","39.24"
"chhattisgarh",2018,4,"5365844","3859604","1506240","39.03"
"sikkim",2019,4,"767070","552436","214634","38.85"
"nagaland",2019,3,"261878","188753","73125","38.74"
"goa",2019,4,"1515272","1092416","422856","38.71"
"haryana",2020,3,"57938179","41781050","16157129","38.67"
"west-bengal",2020,3,"79954504","57676797","22277707","38.63"
"maharashtra",2021,3,"792874060","573616486","219257574","38.22"
"punjab",2018,2,"2581163","1870433","710730","38.00"
"kerala",2018,4,"4310654","3134348","1176306","37.53"
"ladakh",2020,1,"116419","84706","31713","37.44"
"assam",2021,4,"46020361","33504441","12515920","37.36"
"goa",2021,3,"6467763","4710135","1757628","37.32"
"haryana",2018,2,"6150931","4480770","1670161","37.27"
"telangana",2019,2,"89610379","65290702","24319677","37.25"
"meghalaya",2020,1,"502283","365981","136302","37.24"
"jharkhand",2023,1,"240458103","175300092","65158011","37.17"
"chhattisgarh",2018,3,"3859604","2816156","1043448","37.05"
"tripura",2023,1,"7118687","5198190","1920497","36.95"
"nagaland",2020,2,"517566","378051","139515","36.90"
"meghalaya",2018,2,"67857","49571","18286","36.89"
"lakshadweep",2020,1,"5151","3765","1386","36.81"
"uttarakhand",2018,2,"1704122","1246685","457437","36.69"
"tamil-nadu",2019,4,"56596411","41410183","15186228","36.67"
"andhra-pradesh",2018,2,"12353918","9039585","3314333","36.66"
"puducherry",2021,3,"5121726","3751387","1370339","36.53"
"sikkim",2021,4,"1584345","1160594","423751","36.51"
"dadra-&-nagar-haveli-&-daman-&-diu",2018,2,"202626","148549","54077","36.40"
"chandigarh",2021,1,"3970237","2912716","1057521","36.31"
"uttar-pradesh",2018,4,"36100767","26515356","9585411","36.15"
"maharashtra",2018,2,"22285740","16387034","5898706","36.00"
"kerala",2018,3,"3134348","2308165","826183","35.79"
"chhattisgarh",2022,3,"158252587","116584048","41668539","35.74"
"lakshadweep",2020,4,"11650","8589","3061","35.64"
"jharkhand",2021,4,"96009042","70795702","25213340","35.61"
"telangana",2019,3,"121495376","89610379","31884997","35.58"
"tamil-nadu",2020,3,"70277825","51870110","18407715","35.49"
"bihar",2019,4,"43530314","32139900","11390414","35.44"
"bihar",2021,2,"155603622","114932477","40671145","35.39"
"maharashtra",2019,4,"201260620","148735581","52525039","35.31"
"andhra-pradesh",2019,3,"76288614","56409015","19879599","35.24"
"bihar",2020,4,"96591673","71503748","25087925","35.09"
"chandigarh",2020,4,"2912716","2158086","754630","34.97"
"andaman-&-nicobar-islands",2022,2,"1071217","794748","276469","34.79"
"maharashtra",2019,2,"101149853","75079069","26070784","34.72"
"telangana",2019,4,"163572258","121495376","42076882","34.63"
"kerala",2019,4,"12498637","9286096","3212541","34.60"
"rajasthan",2019,3,"67303617","50009286","17294331","34.58"
"odisha",2021,3,"177362674","131824337","45538337","34.54"
"arunachal-pradesh",2018,4,"176429","131146","45283","34.53"
"jharkhand",2020,3,"27068473","20141511","6926962","34.39"
"lakshadweep",2024,2,"109085","81176","27909","34.38"
"ladakh",2019,3,"92396","68772","23624","34.35"
"haryana",2018,3,"8262024","6150931","2111093","34.32"
"puducherry",2023,1,"10144295","7556127","2588168","34.25"
"madhya-pradesh",2022,3,"731259559","544899829","186359730","34.20"
"punjab",2018,3,"3462108","2581163","880945","34.13"
"manipur",2019,3,"345008","257425","87583","34.02"
"manipur",2021,2,"3086275","2303535","782740","33.98"
"bihar",2020,3,"71503748","53386742","18117006","33.94"
"karnataka",2023,1,"1844697189","1378910371","465786818","33.78"
"tripura",2019,3,"711717","532558","179159","33.64"
"punjab",2020,4,"22997925","17209573","5788352","33.63"
"kerala",2020,3,"21758680","16287967","5470713","33.59"
"kerala",2021,3,"63028266","47191033","15837233","33.56"
"gujarat",2021,3,"149248407","111841396","37407011","33.45"
"haryana",2019,3,"30343531","22741816","7601715","33.43"
"karnataka",2019,2,"115401604","86587609","28813995","33.28"
"arunachal-pradesh",2021,2,"1568338","1177456","390882","33.20"
"chhattisgarh",2019,4,"16305758","12243111","4062647","33.18"
"ladakh",2020,2,"155010","116419","38591","33.15"
"sikkim",2022,2,"2322081","1744302","577779","33.12"
"himachal-pradesh",2024,2,"52583801","39520561","13063240","33.05"
"haryana",2021,3,"140459693","105680856","34778837","32.91"
"chandigarh",2022,4,"17904840","13478173","4426667","32.84"
"dadra-&-nagar-haveli-&-daman-&-diu",2021,4,"4157085","3129470","1027615","32.84"
"rajasthan",2021,1,"252730919","190283435","62447484","32.82"
"uttar-pradesh",2021,4,"406157932","306543384","99614548","32.50"
"himachal-pradesh",2020,4,"7272328","5489876","1782452","32.47"
"himachal-pradesh",2022,2,"21291371","16088180","5203191","32.34"
"manipur",2020,2,"1083068","818801","264267","32.27"
"punjab",2021,3,"42533489","32171248","10362241","32.21"
"odisha",2020,3,"66033829","50028576","16005253","31.99"
"meghalaya",2019,3,"306550","232286","74264","31.97"
"gujarat",2019,3,"38228649","28981842","9246807","31.91"
"odisha",2021,4,"233925366","177362674","56562692","31.89"
"chhattisgarh",2021,4,"84717494","64237938","20479556","31.88"
"jammu-&-kashmir",2019,1,"3584987","2721310","863677","31.74"
"assam",2021,3,"33504441","25432905","8071536","31.74"
"andaman-&-nicobar-islands",2021,3,"449764","341414","108350","31.74"
"manipur",2024,2,"5063324","3845564","1217760","31.67"
"delhi",2018,2,"9373723","7122754","2250969","31.60"
"madhya-pradesh",2018,2,"10561412","8025395","2536017","31.60"
"jammu-&-kashmir",2020,3,"3465898","2635006","830892","31.53"
"nagaland",2024,2,"5598700","4258924","1339776","31.46"
"madhya-pradesh",2021,1,"201998498","153652541","48345957","31.46"
"rajasthan",2018,2,"9973697","7591690","2382007","31.38"
"gujarat",2020,4,"77828547","59290179","18538368","31.27"
"madhya-pradesh",2019,3,"53610411","40846013","12764398","31.25"
"meghalaya",2021,4,"1440193","1097731","342462","31.20"
"jammu-&-kashmir",2021,3,"13151041","10027819","3123222","31.15"
"manipur",2020,3,"1420168","1083068","337100","31.12"
"jharkhand",2021,3,"70795702","54002145","16793557","31.10"
"ladakh",2019,1,"46145","35211","10934","31.05"
"uttarakhand",2018,3,"2229132","1704122","525010","30.81"
"nagaland",2022,4,"2476205","1894113","582092","30.73"
"uttarakhand",2020,3,"11818935","9047770","2771165","30.63"
"bihar",2021,4,"245126945","187671113","57455832","30.62"
"delhi",2021,1,"157359004","120540417","36818587","30.54"
"uttarakhand",2022,2,"58166878","44560772","13606106","30.53"
"dadra-&-nagar-haveli-&-daman-&-diu",2019,3,"638751","489656","149095","30.45"
"west-bengal",2019,1,"47626388","36513548","11112840","30.43"
"chhattisgarh",2019,3,"12243111","9389945","2853166","30.39"
"goa",2022,4,"17192674","13188687","4003987","30.36"
"assam",2021,2,"25432905","19512060","5920845","30.34"
"assam",2020,1,"8808860","6760510","2048350","30.30"
"kerala",2018,2,"2308165","1771380","536785","30.30"
"manipur",2019,4,"449344","345008","104336","30.24"
"gujarat",2018,2,"7745733","5948775","1796958","30.21"
"uttarakhand",2021,4,"40361280","31042284","9318996","30.02"
"gujarat",2018,4,"14733303","11334149","3399154","29.99"
"meghalaya",2024,2,"11089661","8531262","2558399","29.99"
"sikkim",2023,2,"4412967","3396128","1016839","29.94"
"kerala",2021,4,"81823741","63028266","18795475","29.82"
"madhya-pradesh",2021,4,"404308084","311443334","92864750","29.82"
"ladakh",2024,3,"6913885","5327359","1586526","29.78"
"tripura",2019,1,"580926","448059","132867","29.65"
"mizoram",2019,3,"98094","75671","22423","29.63"
"assam",2022,2,"76334725","58889886","17444839","29.62"
"meghalaya",2019,1,"208741","161132","47609","29.55"
"uttarakhand",2023,2,"102758214","79385675","23372539","29.44"
"uttarakhand",2021,3,"31042284","24000432","7041852","29.34"
"goa",2020,3,"1915531","1482092","433439","29.25"
"mizoram",2020,2,"198462","153609","44853","29.20"
"himachal-pradesh",2018,3,"886754","687695","199059","28.95"
"uttarakhand",2019,4,"7362116","5710476","1651640","28.92"
"arunachal-pradesh",2023,2,"10360488","8042825","2317663","28.82"
"chandigarh",2018,3,"616936","479084","137852","28.77"
"tamil-nadu",2019,3,"41410183","32171737","9238446","28.72"
"uttarakhand",2024,2,"158564982","123234577","35330405","28.67"
"himachal-pradesh",2019,4,"3516646","2735180","781466","28.57"
"haryana",2023,1,"381318464","296648365","84670099","28.54"
"himachal-pradesh",2023,2,"35061595","27301726","7759869","28.42"
"arunachal-pradesh",2019,1,"226506","176429","50077","28.38"
"mizoram",2020,3,"254703","198462","56241","28.34"
"andaman-&-nicobar-islands",2019,1,"30486","23758","6728","28.32"
"jharkhand",2019,4,"18248618","14220647","4027971","28.32"
"chhattisgarh",2020,3,"24148539","18820925","5327614","28.31"
"jammu-&-kashmir",2018,3,"2303961","1796326","507635","28.26"
"west-bengal",2021,3,"181712988","141897437","39815551","28.06"
"assam",2022,1,"58889886","46020361","12869525","27.96"
"punjab",2019,4,"13698625","10706812","2991813","27.94"
"lakshadweep",2024,1,"81176","63479","17697","27.88"
"manipur",2021,3,"3941396","3086275","855121","27.71"
"jammu-&-kashmir",2021,4,"16790628","13151041","3639587","27.68"
"mizoram",2019,4,"125239","98094","27145","27.67"
"rajasthan",2020,4,"190283435","149088676","41194759","27.63"
"sikkim",2022,4,"3058339","2396758","661581","27.60"
"kerala",2019,3,"9286096","7283826","2002270","27.49"
"maharashtra",2021,4,"1010731502","792874060","217857442","27.48"
"mizoram",2019,1,"70306","55242","15064","27.27"
"himachal-pradesh",2021,3,"12064167","9483902","2580265","27.21"
"kerala",2021,1,"42316342","33288187","9028155","27.12"
"madhya-pradesh",2019,4,"68131989","53610411","14521578","27.09"
"maharashtra",2021,1,"517860240","407621004","110239236","27.04"
"arunachal-pradesh",2022,2,"3556925","2804068","752857","26.85"
"tamil-nadu",2021,4,"259155976","204357404","54798572","26.82"
"uttar-pradesh",2021,3,"306543384","241949131","64594253","26.70"
"mizoram",2020,4,"322607","254703","67904","26.66"
"bihar",2022,2,"360145029","284390434","75754595","26.64"
"uttar-pradesh",2019,4,"86905005","68623959","18281046","26.64"
"assam",2021,1,"19512060","15423454","4088606","26.51"
"meghalaya",2020,2,"635395","502283","133112","26.50"
"rajasthan",2019,4,"85074242","67303617","17770625","26.40"
"uttar-pradesh",2020,3,"127405259","100851965","26553294","26.33"
"telangana",2018,2,"10764670","8522766","2241904","26.30"
"meghalaya",2020,4,"754008","597579","156429","26.18"
"bihar",2023,4,"924427274","734238751","190188523","25.90"
"kerala",2020,1,"15733522","12498637","3234885","25.88"
"punjab",2019,3,"10706812","8509830","2196982","25.82"
"telangana",2021,3,"622886768","495867544","127019224","25.62"
"uttar-pradesh",2022,2,"595298776","473953246","121345530","25.60"
"lakshadweep",2024,4,"197777","157478","40299","25.59"
"arunachal-pradesh",2020,4,"1209129","962827","246302","25.58"
"arunachal-pradesh",2024,3,"24447142","19478372","4968770","25.51"
"west-bengal",2020,4,"100340645","79954504","20386141","25.50"
"goa",2024,4,"46131536","36762111","9369425","25.49"
"chandigarh",2018,2,"479084","381895","97189","25.45"
"andaman-&-nicobar-islands",2022,4,"1987535","1584379","403156","25.45"
"arunachal-pradesh",2021,4,"2390598","1906967","483631","25.36"
"tripura",2020,4,"1651890","1317885","334005","25.34"
"lakshadweep",2021,2,"11384","9085","2299","25.31"
"lakshadweep",2023,3,"43757","34918","8839","25.31"
"chandigarh",2022,2,"10772489","8600491","2171998","25.25"
"tripura",2020,3,"1317885","1052520","265365","25.21"
"punjab",2022,2,"72272823","57758302","14514521","25.13"
"chandigarh",2022,3,"13478173","10772489","2705684","25.12"
"gujarat",2020,3,"59290179","47420185","11869994","25.03"
"puducherry",2018,2,"130261","104212","26049","25.00"
"andaman-&-nicobar-islands",2022,1,"794748","636123","158625","24.94"
"madhya-pradesh",2018,4,"21397555","17126985","4270570","24.93"
"delhi",2020,4,"120540417","96491861","24048556","24.92"
"bihar",2023,2,"683933094","547831195","136101899","24.84"
"manipur",2018,4,"236110","189258","46852","24.76"
"manipur",2018,3,"189258","151721","37537","24.74"
"nagaland",2024,3,"6981635","5598700","1382935","24.70"
"haryana",2019,4,"37825985","30343531","7482454","24.66"
"telangana",2021,4,"775989773","622886768","153103005","24.58"
"himachal-pradesh",2021,2,"9483902","7614029","1869873","24.56"
"tripura",2022,3,"4256579","3418664","837915","24.51"
"assam",2020,4,"15423454","12397711","3025743","24.41"
"puducherry",2021,4,"6368810","5121726","1247084","24.35"
"goa",2020,1,"1881237","1515272","365965","24.15"
"arunachal-pradesh",2019,4,"459475","370234","89241","24.10"
"delhi",2022,2,"410634184","330999861","79634323","24.06"
"uttarakhand",2020,1,"9131784","7362116","1769668","24.04"
"goa",2023,4,"33460978","26999728","6461250","23.93"
"west-bengal",2021,4,"225029560","181712988","43316572","23.84"
"karnataka",2021,4,"931725438","753296539","178428899","23.69"
"puducherry",2019,3,"716826","580077","136749","23.57"
"arunachal-pradesh",2023,3,"12802433","10360488","2441945","23.57"
"sikkim",2024,2,"7188322","5820146","1368176","23.51"
"arunachal-pradesh",2020,1,"567175","459475","107700","23.44"
"odisha",2022,3,"386687326","313451598","73235728","23.36"
"sikkim",2020,4,"735035","596435","138600","23.24"
"punjab",2021,4,"52359360","42533489","9825871","23.10"
"ladakh",2023,3,"3621366","2943815","677551","23.02"
"madhya-pradesh",2022,4,"898828268","731259559","167568709","22.92"
"chandigarh",2019,4,"1850915","1506543","344372","22.86"
"tamil-nadu",2021,1,"136556674","111179701","25376973","22.83"
"mizoram",2020,1,"153609","125239","28370","22.65"
"gujarat",2021,4,"182987325","149248407","33738918","22.61"
"delhi",2021,4,"292683359","238760608","53922751","22.58"
"assam",2024,2,"271327087","221525056","49802031","22.48"
"andhra-pradesh",2021,3,"432032550","352767134","79265416","22.47"
"haryana",2022,2,"234699962","191988609","42711353","22.25"
"chandigarh",2020,1,"2262511","1850915","411596","22.24"
"haryana",2024,2,"738553925","604293500","134260425","22.22"
"punjab",2020,3,"17209573","14081294","3128279","22.22"
"tripura",2022,4,"5198190","4256579","941611","22.12"
"meghalaya",2022,2,"2044649","1674750","369899","22.09"
"sikkim",2021,2,"976714","800189","176525","22.06"
"telangana",2020,1,"199409525","163572258","35837267","21.91"
"meghalaya",2023,2,"5077212","4164705","912507","21.91"
"uttarakhand",2022,4,"77983880","63996519","13987361","21.86"
"puducherry",2021,1,"3309432","2716003","593429","21.85"
"rajasthan",2021,4,"487621597","400284753","87336844","21.82"
"bihar",2024,2,"1313888385","1078734783","235153602","21.80"
"gujarat",2021,1,"94774565","77828547","16946018","21.77"
"andhra-pradesh",2021,2,"352767134","289747970","63019164","21.75"
"meghalaya",2021,2,"909594","747646","161948","21.66"
"delhi",2019,3,"69537876","57171512","12366364","21.63"
"delhi",2019,2,"57171512","47007327","10164185","21.62"
"jammu-&-kashmir",2021,1,"6997570","5754444","1243126","21.60"
"arunachal-pradesh",2021,3,"1906967","1568338","338629","21.59"
"himachal-pradesh",2021,4,"14666864","12064167","2602697","21.57"
"assam",2023,2,"138290953","113760638","24530315","21.56"
"mizoram",2024,2,"1977079","1627016","350063","21.52"
"bihar",2022,3,"437367385","360145029","77222356","21.44"
"assam",2019,1,"4533005","3734172","798833","21.39"
"karnataka",2021,1,"523797492","431536984","92260508","21.38"
"mizoram",2021,3,"478529","394340","84189","21.35"
"lakshadweep",2019,4,"3765","3104","661","21.30"
"jammu-&-kashmir",2022,4,"27316158","22534394","4781764","21.22"
"west-bengal",2022,2,"315742141","260505092","55237049","21.20"
"assam",2023,3,"167575351","138290953","29284398","21.18"
"chandigarh",2024,2,"15940973","13155173","2785800","21.18"
"tripura",2021,4,"2520693","2081200","439493","21.12"
"nagaland",2019,4,"317170","261878","55292","21.11"
"punjab",2023,2,"117290289","96910821","20379468","21.03"
"jharkhand",2021,2,"54002145","44621663","9380482","21.02"
"nagaland",2019,1,"168579","139333","29246","20.99"
"andhra-pradesh",2021,4,"522254003","432032550","90221453","20.88"
"uttar-pradesh",2023,2,"1211410582","1002557722","208852860","20.83"
"haryana",2021,4,"169686975","140459693","29227282","20.81"
"karnataka",2022,2,"1277448960","1057855407","219593553","20.76"
"assam",2022,4,"103981267","86113811","17867456","20.75"
"odisha",2021,1,"111460358","92324950","19135408","20.73"
"meghalaya",2021,3,"1097731","909594","188137","20.68"
"chhattisgarh",2023,1,"214748957","177960446","36788511","20.67"
"punjab",2024,2,"171946137","142537179","29408958","20.63"
"bihar",2021,3,"187671113","155603622","32067491","20.61"
"meghalaya",2023,4,"7268384","6029842","1238542","20.54"
"dadra-&-nagar-haveli-&-daman-&-diu",2019,4,"768971","638751","130220","20.39"
"maharashtra",2022,2,"1407533113","1169506438","238026675","20.35"
"tamil-nadu",2022,2,"354506937","294573150","59933787","20.35"
"assam",2019,2,"5454929","4533005","921924","20.34"
"gujarat",2022,3,"303239732","252052796","51186936","20.31"
"chandigarh",2019,3,"1506543","1252470","254073","20.29"
"jharkhand",2023,2,"289233893","240458103","48775790","20.28"
"nagaland",2021,4,"1631483","1356792","274691","20.25"
"rajasthan",2020,1,"102258812","85074242","17184570","20.20"
"telangana",2021,2,"495867544","412572110","83295434","20.19"
"punjab",2021,2,"32171248","26770835","5400413","20.17"
"telangana",2021,1,"412572110","343643787","68928323","20.06"
"andhra-pradesh",2018,4,"30759548","25626061","5133487","20.03"
"nagaland",2021,3,"1356792","1130791","226001","19.99"
"west-bengal",2021,2,"141897437","118254052","23643385","19.99"
"haryana",2023,2,"457536190","381318464","76217726","19.99"
"telangana",2022,2,"1063382557","886453385","176929172","19.96"
"dadra-&-nagar-haveli-&-daman-&-diu",2022,2,"5759771","4802803","956968","19.93"
"uttar-pradesh",2023,1,"1002557722","836369071","166188651","19.87"
"jharkhand",2022,2,"132925275","110911210","22014065","19.85"
"sikkim",2024,1,"5820146","4857324","962822","19.82"
"chhattisgarh",2020,1,"19523991","16305758","3218233","19.74"
"gujarat",2022,2,"252052796","210547146","41505650","19.71"
"chhattisgarh",2022,2,"116584048","97413292","19170756","19.68"
"mizoram",2021,2,"394340","329575","64765","19.65"
"uttar-pradesh",2024,2,"2135538658","1785296948","350241710","19.62"
"delhi",2024,2,"777540400","650734058","126806342","19.49"
"jharkhand",2022,4,"175300092","146815332","28484760","19.40"
"meghalaya",2019,4,"365981","306550","59431","19.39"
"mizoram",2024,3,"2360206","1977079","383127","19.38"
"tripura",2021,3,"2081200","1744429","336771","19.31"
"puducherry",2020,1,"1207921","1012655","195266","19.28"
"andaman-&-nicobar-islands",2023,4,"3695783","3098376","597407","19.28"
"assam",2020,2,"10505199","8808860","1696339","19.26"
"nagaland",2020,1,"378051","317170","60881","19.20"
"andhra-pradesh",2020,1,"127677357","107218103","20459254","19.08"
"dadra-&-nagar-haveli-&-daman-&-diu",2023,4,"18302373","15370328","2932045","19.08"
"tripura",2022,2,"3418664","2871190","547474","19.07"
"chhattisgarh",2019,2,"9389945","7887669","1502276","19.05"
"arunachal-pradesh",2020,3,"962827","808774","154053","19.05"
"bihar",2021,1,"114932477","96591673","18340804","18.99"
"lakshadweep",2020,3,"8589","7220","1369","18.96"
"andaman-&-nicobar-islands",2023,2,"2707775","2276392","431383","18.95"
"manipur",2021,4,"4687439","3941396","746043","18.93"
"odisha",2022,2,"313451598","263633499","49818099","18.90"
"uttar-pradesh",2022,4,"836369071","703589072","132779999","18.87"
"sikkim",2021,3,"1160594","976714","183880","18.83"
"chandigarh",2021,4,"7898903","6649378","1249525","18.79"
"meghalaya",2023,3,"6029842","5077212","952630","18.76"
"west-bengal",2023,2,"545317686","459278344","86039342","18.73"
"arunachal-pradesh",2024,2,"19478372","16406414","3071958","18.72"
"maharashtra",2020,1,"238944081","201260620","37683461","18.72"
"punjab",2019,2,"8509830","7172137","1337693","18.65"
"uttarakhand",2019,3,"5710476","4813275","897201","18.64"
"tripura",2018,4,"448059","377703","70356","18.63"
"rajasthan",2024,1,"1599474007","1349472154","250001853","18.53"
"bihar",2020,2,"53386742","45081815","8304927","18.42"
"uttar-pradesh",2021,2,"241949131","204499547","37449584","18.31"
"tamil-nadu",2020,1,"66953473","56596411","10357062","18.30"
"lakshadweep",2023,2,"34918","29520","5398","18.29"
"odisha",2021,2,"131824337","111460358","20363979","18.27"
"bihar",2022,4,"517084649","437367385","79717264","18.23"
"uttar-pradesh",2022,3,"703589072","595298776","108290296","18.19"
"himachal-pradesh",2022,3,"25164868","21291371","3873497","18.19"
"jammu-&-kashmir",2018,4,"2721310","2303961","417349","18.11"
"nagaland",2022,1,"1925952","1631483","294469","18.05"
"odisha",2024,1,"864178452","732137476","132040976","18.03"
"assam",2020,3,"12397711","10505199","1892512","18.02"
"gujarat",2021,2,"111841396","94774565","17066831","18.01"
"lakshadweep",2019,2,"2926","2481","445","17.94"
"west-bengal",2021,1,"118254052","100340645","17913407","17.85"
"himachal-pradesh",2020,1,"4144480","3516646","627834","17.85"
"chandigarh",2023,2,"11553687","9815605","1738082","17.71"
"jharkhand",2023,4,"374538362","318237426","56300936","17.69"
"delhi",2023,2,"482138998","409753103","72385895","17.67"
"odisha",2023,4,"732137476","622397603","109739873","17.63"
"arunachal-pradesh",2022,4,"4632709","3939418","693291","17.60"
"andaman-&-nicobar-islands",2020,1,"41298","35159","6139","17.46"
"lakshadweep",2021,3,"13370","11384","1986","17.45"
"puducherry",2022,2,"8643687","7359176","1284511","17.45"
"meghalaya",2024,1,"8531262","7268384","1262878","17.37"
"arunachal-pradesh",2022,1,"2804068","2390598","413470","17.30"
"west-bengal",2024,2,"980480707","836408587","144072120","17.23"
"nagaland",2023,3,"3422331","2922001","500330","17.12"
"jharkhand",2024,2,"499685871","426759095","72926776","17.09"
"haryana",2021,2,"105680856","90252784","15428072","17.09"
"jammu-&-kashmir",2023,3,"63903579","54588299","9315280","17.06"
"rajasthan",2022,2,"661170150","564962220","96207930","17.03"
"uttarakhand",2021,1,"20608402","17613271","2995131","17.00"
"meghalaya",2024,4,"14166380","12110124","2056256","16.98"
"dadra-&-nagar-haveli-&-daman-&-diu",2020,3,"1138312","973152","165160","16.97"
"madhya-pradesh",2022,1,"472703058","404308084","68394974","16.92"
"himachal-pradesh",2020,3,"5489876","4695730","794146","16.91"
"west-bengal",2023,4,"737953238","632093191","105860047","16.75"
"bihar",2024,1,"1078734783","924427274","154307509","16.69"
"uttar-pradesh",2022,1,"473953246","406157932","67795314","16.69"
"madhya-pradesh",2024,1,"1286156614","1102294613","183862001","16.68"
"uttar-pradesh",2019,3,"68623959","58883500","9740459","16.54"
"rajasthan",2023,2,"1073459338","921096686","152362652","16.54"
"madhya-pradesh",2020,1,"79366746","68131989","11234757","16.49"
"punjab",2022,3,"84177897","72272823","11905074","16.47"
"uttarakhand",2021,2,"24000432","20608402","3392030","16.46"
"kerala",2022,1,"95280965","81823741","13457224","16.45"
"haryana",2020,1,"44036087","37825985","6210102","16.42"
"punjab",2021,1,"26770835","22997925","3772910","16.41"
"goa",2022,2,"14216054","12214098","2001956","16.39"
"chhattisgarh",2023,2,"249931636","214748957","35182679","16.38"
"meghalaya",2022,1,"1674750","1440193","234557","16.29"
"delhi",2019,4,"80744997","69537876","11207121","16.12"
"rajasthan",2022,3,"767541360","661170150","106371210","16.09"
"bihar",2022,1,"284390434","245126945","39263489","16.02"
"gujarat",2019,2,"28981842","24991451","3990391","15.97"
"himachal-pradesh",2023,4,"38651839","33337054","5314785","15.94"
"west-bengal",2023,3,"632093191","545317686","86775505","15.91"
"karnataka",2022,4,"1378910371","1189761328","189149043","15.90"
"nagaland",2021,2,"1130791","975897","154894","15.87"
"rajasthan",2022,1,"564962220","487621597","77340623","15.86"
"delhi",2022,3,"475592161","410634184","64957977","15.82"
"tripura",2024,2,"12787547","11042639","1744908","15.80"
"puducherry",2019,2,"580077","501092","78985","15.76"
"west-bengal",2022,1,"260505092","225029560","35475532","15.76"
"lakshadweep",2021,4,"15470","13370","2100","15.71"
"maharashtra",2022,1,"1169506438","1010731502","158774936","15.71"
"uttar-pradesh",2023,4,"1566705382","1354622466","212082916","15.66"
"mizoram",2021,4,"553329","478529","74800","15.63"
"telangana",2023,2,"1665430971","1440331458","225099513","15.63"
"assam",2023,4,"193752157","167575351","26176806","15.62"
"sikkim",2024,4,"8916870","7713781","1203089","15.60"
"puducherry",2022,1,"7359176","6368810","990366","15.55"
"dadra-&-nagar-haveli-&-daman-&-diu",2022,1,"4802803","4157085","645718","15.53"
"jharkhand",2022,1,"110911210","96009042","14902168","15.52"
"madhya-pradesh",2023,2,"848037060","734566970","113470090","15.45"
"madhya-pradesh",2023,3,"978812593","848037060","130775533","15.42"
"tripura",2021,2,"1744429","1511423","233006","15.42"
"himachal-pradesh",2019,2,"2502306","2168718","333588","15.38"
"dadra-&-nagar-haveli-&-daman-&-diu",2024,1,"21115009","18302373","2812636","15.37"
"tripura",2020,1,"924502","801824","122678","15.30"
"bihar",2024,4,"1559667675","1352876223","206791452","15.29"
"madhya-pradesh",2022,2,"544899829","472703058","72196771","15.27"
"odisha",2022,4,"445714743","386687326","59027417","15.26"
"rajasthan",2023,3,"1237232167","1073459338","163772829","15.26"
"sikkim",2020,3,"596435","517731","78704","15.20"
"andhra-pradesh",2022,2,"671134030","582603911","88530119","15.20"
"nagaland",2020,4,"847825","736319","111506","15.14"
"nagaland",2021,1,"975897","847825","128072","15.11"
"dadra-&-nagar-haveli-&-daman-&-diu",2023,3,"15370328","13357115","2013213","15.07"
"gujarat",2022,1,"210547146","182987325","27559821","15.06"
"gujarat",2023,2,"416922553","362511326","54411227","15.01"
"chhattisgarh",2022,1,"97413292","84717494","12695798","14.99"
"gujarat",2023,3,"479303590","416922553","62381037","14.96"
"manipur",2022,2,"6105632","5313679","791953","14.90"
"tripura",2023,3,"9108762","7929543","1179219","14.87"
"andaman-&-nicobar-islands",2024,4,"6063900","5279250","784650","14.86"
"mizoram",2023,2,"1208930","1052595","156335","14.85"
"uttar-pradesh",2021,1,"204499547","178167517","26332030","14.78"
"haryana",2022,3,"269361810","234699962","34661848","14.77"
"manipur",2020,4,"1627852","1420168","207684","14.62"
"karnataka",2023,3,"2369262302","2067867526","301394776","14.58"
"andaman-&-nicobar-islands",2023,1,"2276392","1987535","288857","14.53"
"mizoram",2023,4,"1500728","1310413","190315","14.52"
"mizoram",2024,4,"2702443","2360206","342237","14.50"
"andaman-&-nicobar-islands",2023,3,"3098376","2707775","390601","14.43"
"assam",2024,1,"221525056","193752157","27772899","14.33"
"odisha",2023,3,"622397603","544597829","77799774","14.29"
"dadra-&-nagar-haveli-&-daman-&-diu",2020,1,"878579","768971","109608","14.25"
"telangana",2022,1,"886453385","775989773","110463612","14.24"
"arunachal-pradesh",2019,2,"258656","226506","32150","14.19"
"arunachal-pradesh",2023,4,"14617742","12802433","1815309","14.18"
"andhra-pradesh",2023,2,"1305656964","1145532464","160124500","13.98"
"karnataka",2020,1,"271033890","237796252","33237638","13.98"
"uttar-pradesh",2024,1,"1785296948","1566705382","218591566","13.95"
"jharkhand",2024,1,"426759095","374538362","52220733","13.94"
"tripura",2022,1,"2871190","2520693","350497","13.90"
"tripura",2020,2,"1052520","924502","128018","13.85"
"gujarat",2024,2,"690395153","606576671","83818482","13.82"
"rajasthan",2019,2,"50009286","43956040","6053246","13.77"
"chhattisgarh",2024,1,"366176684","321876332","44300352","13.76"
"assam",2019,4,"6760510","5942571","817939","13.76"
"west-bengal",2022,4,"405847597","356792388","49055209","13.75"
"rajasthan",2021,2,"287477039","252730919","34746120","13.75"
"rajasthan",2024,2,"1818855106","1599474007","219381099","13.72"
"bihar",2019,2,"29960479","26356234","3604245","13.68"
"tamil-nadu",2022,1,"294573150","259155976","35417174","13.67"
"maharashtra",2022,4,"1688775272","1486389417","202385855","13.62"
"gujarat",2024,1,"606576671","534115578","72461093","13.57"
"karnataka",2022,1,"1057855407","931725438","126129969","13.54"
"chhattisgarh",2023,4,"321876332","283492657","38383675","13.54"
"andhra-pradesh",2020,2,"144917855","127677357","17240498","13.50"
"himachal-pradesh",2022,4,"28555136","25164868","3390268","13.47"
"nagaland",2024,4,"7921552","6981635","939917","13.46"
"andaman-&-nicobar-islands",2024,3,"5279250","4653224","626026","13.45"
"chhattisgarh",2023,3,"283492657","249931636","33561021","13.43"
"delhi",2023,3,"546706983","482138998","64567985","13.39"
"manipur",2022,1,"5313679","4687439","626240","13.36"
"puducherry",2021,2,"3751387","3309432","441955","13.35"
"west-bengal",2024,1,"836408587","737953238","98455349","13.34"
"chhattisgarh",2021,2,"44689420","39436437","5252983","13.32"
"himachal-pradesh",2020,2,"4695730","4144480","551250","13.30"
"andaman-&-nicobar-islands",2024,1,"4184920","3695783","489137","13.24"
"west-bengal",2023,1,"459278344","405847597","53430747","13.17"
"jharkhand",2021,1,"44621663","39431633","5190030","13.16"
"dadra-&-nagar-haveli-&-daman-&-diu",2023,2,"13357115","11803985","1553130","13.16"
"haryana",2022,1,"191988609","169686975","22301634","13.14"
"west-bengal",2024,4,"1227135682","1084916445","142219237","13.11"
"delhi",2022,1,"330999861","292683359","38316502","13.09"
"west-bengal",2022,3,"356792388","315742141","41050247","13.00"
"andhra-pradesh",2023,3,"1475164403","1305656964","169507439","12.98"
"chandigarh",2023,3,"13052165","11553687","1498478","12.97"
"chhattisgarh",2024,4,"500655404","443640102","57015302","12.85"
"assam",2022,3,"86113811","76334725","9779086","12.81"
"odisha",2023,2,"544597829","482896088","61701741","12.78"
"rajasthan",2022,4,"865574848","767541360","98033488","12.77"
"odisha",2022,1,"263633499","233925366","29708133","12.70"
"punjab",2023,3,"132161181","117290289","14870892","12.68"
"tripura",2019,4,"801824","711717","90107","12.66"
"madhya-pradesh",2023,4,"1102294613","978812593","123482020","12.62"
"tripura",2024,3,"14400581","12787547","1613034","12.61"
"kerala",2019,2,"7283826","6469039","814787","12.60"
"telangana",2023,3,"1875045924","1665430971","209614953","12.59"
"manipur",2024,3,"5700096","5063324","636772","12.58"
"assam",2024,4,"332441531","295345591","37095940","12.56"
"chhattisgarh",2024,2,"412047705","366176684","45871021","12.53"
"lakshadweep",2022,4,"17147","15241","1906","12.51"
"gujarat",2022,4,"341156018","303239732","37916286","12.50"
"chhattisgarh",2022,4,"177960446","158252587","19707859","12.45"
"manipur",2019,1,"265409","236110","29299","12.41"
"jharkhand",2024,4,"586904686","522575883","64328803","12.31"
"maharashtra",2023,4,"2572162725","2290678587","281484138","12.29"
"dadra-&-nagar-haveli-&-daman-&-diu",2022,3,"6465621","5759771","705850","12.25"
"arunachal-pradesh",2024,1,"16406414","14617742","1788672","12.24"
"kerala",2022,3,"119362904","106365322","12997582","12.22"
"nagaland",2024,1,"4258924","3797179","461745","12.16"
"karnataka",2023,2,"2067867526","1844697189","223170337","12.10"
"nagaland",2019,2,"188753","168579","20174","11.97"
"uttar-pradesh",2020,1,"97239132","86905005","10334127","11.89"
"dadra-&-nagar-haveli-&-daman-&-diu",2024,4,"28463700","25446270","3017430","11.86"
"uttar-pradesh",2023,3,"1354622466","1211410582","143211884","11.82"
"telangana",2022,4,"1819506832","1628165401","191341431","11.75"
"maharashtra",2023,2,"2063717848","1848268499","215449349","11.66"
"odisha",2024,4,"1143097568","1023940349","119157219","11.64"
"kerala",2022,2,"106365322","95280965","11084357","11.63"
"madhya-pradesh",2024,2,"1435472057","1286156614","149315443","11.61"
"tamil-nadu",2023,3,"556085008","498429638","57655370","11.57"
"andhra-pradesh",2022,1,"582603911","522254003","60349908","11.56"
"kerala",2021,2,"47191033","42316342","4874691","11.52"
"gujarat",2023,4,"534115578","479303590","54811988","11.44"
"tripura",2023,2,"7929543","7118687","810856","11.39"
"kerala",2022,4,"132960468","119362904","13597564","11.39"
"uttar-pradesh",2024,4,"2544890265","2285955833","258934432","11.33"
"tripura",2023,4,"10140910","9108762","1032148","11.33"
"gujarat",2019,4,"42547632","38228649","4318983","11.30"
"meghalaya",2019,2,"232286","208741","23545","11.28"
"chandigarh",2021,2,"4417547","3970237","447310","11.27"
"gujarat",2020,1,"47326417","42547632","4778785","11.23"
"puducherry",2023,3,"12379641","11130326","1249315","11.22"
"dadra-&-nagar-haveli-&-daman-&-diu",2022,4,"7189585","6465621","723964","11.20"
"andaman-&-nicobar-islands",2024,2,"4653224","4184920","468304","11.19"
"chandigarh",2024,3,"17708385","15940973","1767412","11.09"
"uttarakhand",2023,4,"118071440","106284687","11786753","11.09"
"punjab",2020,1,"15217784","13698625","1519159","11.09"
"sikkim",2023,1,"3396128","3058339","337789","11.04"
"kerala",2023,1,"147621565","132960468","14661097","11.03"
"maharashtra",2023,3,"2290678587","2063717848","226960739","11.00"
"chhattisgarh",2021,1,"39436437","35529636","3906801","11.00"
"tamil-nadu",2022,3,"393496175","354506937","38989238","11.00"
"nagaland",2023,4,"3797179","3422331","374848","10.95"
"telangana",2024,2,"2417264357","2179385307","237879050","10.91"
"tamil-nadu",2022,4,"436316636","393496175","42820461","10.88"
"dadra-&-nagar-haveli-&-daman-&-diu",2024,2,"23393115","21115009","2278106","10.79"
"maharashtra",2021,2,"573616486","517860240","55756246","10.77"
"dadra-&-nagar-haveli-&-daman-&-diu",2020,2,"973152","878579","94573","10.76"
"arunachal-pradesh",2022,3,"3939418","3556925","382493","10.75"
"tripura",2024,4,"15945159","14400581","1544578","10.73"
"west-bengal",2024,3,"1084916445","980480707","104435738","10.65"
"haryana",2023,4,"554748233","501519478","53228755","10.61"
"maharashtra",2024,4,"3634231839","3287403995","346827844","10.55"
"madhya-pradesh",2021,2,"223314680","201998498","21316182","10.55"
"jammu-&-kashmir",2024,3,"119555288","108179014","11376274","10.52"
"andaman-&-nicobar-islands",2019,2,"33689","30486","3203","10.51"
"jharkhand",2022,3,"146815332","132925275","13890057","10.45"
"tamil-nadu",2024,3,"778536701","705083686","73453015","10.42"
"uttarakhand",2022,1,"44560772","40361280","4199492","10.40"
"dadra-&-nagar-haveli-&-daman-&-diu",2021,2,"2125083","1925244","199839","10.38"
"punjab",2022,1,"57758302","52359360","5398942","10.31"
"maharashtra",2024,1,"2835770481","2572162725","263607756","10.25"
"kerala",2024,3,"214695458","194872467","19822991","10.17"
"jharkhand",2020,2,"20141511","18282713","1858798","10.17"
"goa",2022,1,"12214098","11088759","1125339","10.15"
"haryana",2022,4,"296648365","269361810","27286555","10.13"
"tamil-nadu",2024,2,"705083686","640327197","64756489","10.11"
"sikkim",2022,1,"1744302","1584345","159957","10.10"
"jharkhand",2023,3,"318237426","289233893","29003533","10.03"
"uttarakhand",2022,3,"63996519","58166878","5829641","10.02"
"andhra-pradesh",2024,2,"1930122300","1755428485","174693815","9.95"
"andhra-pradesh",2024,1,"1755428485","1596987426","158441059","9.92"
"puducherry",2024,3,"16008711","14564895","1443816","9.91"
"andhra-pradesh",2024,4,"2296445544","2091371362","205074182","9.81"
"puducherry",2023,2,"11130326","10144295","986031","9.72"
"gujarat",2024,3,"757441250","690395153","67046097","9.71"
"himachal-pradesh",2022,1,"16088180","14666864","1421316","9.69"
"goa",2023,2,"26530590","24195070","2335520","9.65"
"haryana",2023,3,"501519478","457536190","43983288","9.61"
"arunachal-pradesh",2024,4,"26793457","24447142","2346315","9.60"
"madhya-pradesh",2024,4,"1685401835","1537738457","147663378","9.60"
"madhya-pradesh",2019,2,"40846013","37301049","3544964","9.50"
"bihar",2018,4,"15732401","14367804","1364597","9.50"
"maharashtra",2023,1,"1848268499","1688775272","159493227","9.44"
"delhi",2023,4,"598150746","546706983","51443763","9.41"
"assam",2023,1,"113760638","103981267","9779371","9.40"
"mizoram",2022,1,"604917","553329","51588","9.32"
"himachal-pradesh",2019,3,"2735180","2502306","232874","9.31"
"kerala",2023,3,"170658651","156170617","14488034","9.28"
"odisha",2024,2,"944027735","864178452","79849283","9.24"
"gujarat",2024,4,"827374966","757441250","69933716","9.23"
"meghalaya",2024,3,"12110124","11089661","1020463","9.20"
"punjab",2022,4,"91835180","84177897","7657283","9.10"
"punjab",2024,3,"187554720","171946137","15608583","9.08"
"rajasthan",2023,4,"1349472154","1237232167","112239987","9.07"
"karnataka",2024,1,"2796439155","2564434164","232004991","9.05"
"andaman-&-nicobar-islands",2021,1,"244752","224531","20221","9.01"
"assam",2019,3,"5942571","5454929","487642","8.94"
"haryana",2024,1,"604293500","554748233","49545267","8.93"
"tripura",2024,1,"11042639","10140910","901729","8.89"
"chandigarh",2022,1,"8600491","7898903","701588","8.88"
"sikkim",2023,3,"4804937","4412967","391970","8.88"
"sikkim",2021,1,"800189","735035","65154","8.86"
"assam",2024,3,"295345591","271327087","24018504","8.85"
"nagaland",2023,2,"2922001","2685570","236431","8.80"
"delhi",2024,1,"650734058","598150746","52583312","8.79"
"karnataka",2024,2,"3042012848","2796439155","245573693","8.78"
"dadra-&-nagar-haveli-&-daman-&-diu",2024,3,"25446270","23393115","2053155","8.78"
"delhi",2024,3,"844844523","777540400","67304123","8.66"
"jammu-&-kashmir",2024,1,"75116355","69167132","5949223","8.60"
"kerala",2024,4,"233112441","214695458","18416983","8.58"
"haryana",2021,1,"90252784","83171439","7081345","8.51"
"odisha",2024,3,"1023940349","944027735","79912614","8.47"
"nagaland",2023,1,"2685570","2476205","209365","8.46"
"mizoram",2024,1,"1627016","1500728","126288","8.42"
"mizoram",2023,3,"1310413","1208930","101483","8.39"
"andhra-pradesh",2024,3,"2091371362","1930122300","161249062","8.35"
"odisha",2023,1,"482896088","445714743","37181345","8.34"
"delhi",2022,4,"515203457","475592161","39611296","8.33"
"puducherry",2024,2,"14564895","13446950","1117945","8.31"
"andhra-pradesh",2023,4,"1596987426","1475164403","121823023","8.26"
"karnataka",2023,4,"2564434164","2369262302","195171862","8.24"
"jammu-&-kashmir",2023,4,"69167132","63903579","5263553","8.24"
"himachal-pradesh",2024,4,"53798398","49737549","4060849","8.16"
"delhi",2021,2,"170157264","157359004","12798260","8.13"
"telangana",2024,4,"2822451603","2610137835","212313768","8.13"
"tamil-nadu",2023,2,"498429638","461212387","37217251","8.07"
"maharashtra",2024,2,"3063494802","2835770481","227724321","8.03"
"telangana",2024,3,"2610137835","2417264357","192873478","7.98"
"jharkhand",2019,2,"10128211","9387708","740503","7.89"
"tamil-nadu",2024,1,"640327197","593481381","46845816","7.89"
"telangana",2024,1,"2179385307","2020822178","158563129","7.85"
"delhi",2024,4,"910543082","844844523","65698559","7.78"
"telangana",2023,4,"2020822178","1875045924","145776254","7.77"
"chhattisgarh",2024,3,"443640102","412047705","31592397","7.67"
"mizoram",2019,2,"75671","70306","5365","7.63"
"haryana",2024,3,"794940220","738553925","56386295","7.63"
"punjab",2023,4,"142228995","132161181","10067814","7.62"
"uttarakhand",2024,4,"171136132","159278815","11857317","7.44"
"kerala",2024,2,"194872467","181463966","13408501","7.39"
"bihar",2023,3,"734238751","683933094","50305657","7.36"
"andhra-pradesh",2022,4,"690017077","642855035","47162042","7.34"
"sikkim",2024,3,"7713781","7188322","525459","7.31"
"maharashtra",2024,3,"3287403995","3063494802","223909193","7.31"
"puducherry",2022,4,"7556127","7042727","513400","7.29"
"bihar",2019,3,"32139900","29960479","2179421","7.27"
"karnataka",2024,3,"3261134095","3042012848","219121247","7.20"
"lakshadweep",2022,2,"17569","16397","1172","7.15"
"madhya-pradesh",2024,3,"1537738457","1435472057","102266400","7.12"
"uttar-pradesh",2024,3,"2285955833","2135538658","150417175","7.04"
"tamil-nadu",2021,2,"146158442","136556674","9601768","7.03"
"tamil-nadu",2023,4,"593481381","556085008","37396373","6.72"
"ladakh",2021,4,"630187","590987","39200","6.63"
"ladakh",2022,3,"1190858","1118073","72785","6.51"
"mizoram",2022,2,"643977","604917","39060","6.46"
"rajasthan",2024,3,"1935405035","1818855106","116549929","6.41"
"rajasthan",2023,1,"921096686","865574848","55521838","6.41"
"punjab",2024,4,"199509220","187554720","11954500","6.37"
"gujarat",2023,1,"362511326","341156018","21355308","6.26"
"lakshadweep",2019,3,"3104","2926","178","6.08"
"lakshadweep",2022,1,"16397","15470","927","5.99"
"bihar",2023,1,"547831195","517084649","30746546","5.95"
"karnataka",2024,4,"3455056424","3261134095","193922329","5.95"
"meghalaya",2023,1,"4164705","3932448","232257","5.91"
"dadra-&-nagar-haveli-&-daman-&-diu",2021,1,"1925244","1817791","107453","5.91"
"haryana",2024,4,"841394290","794940220","46454070","5.84"
"kerala",2023,2,"156170617","147621565","8549052","5.79"
"tamil-nadu",2023,1,"461212387","436316636","24895751","5.71"
"goa",2024,2,"37000806","35013987","1986819","5.67"
"jammu-&-kashmir",2024,4,"126261217","119555288","6705929","5.61"
"maharashtra",2022,3,"1486389417","1407533113","78856304","5.60"
"rajasthan",2024,4,"2043469547","1935405035","108064512","5.58"
"punjab",2023,1,"96910821","91835180","5075641","5.53"
"nagaland",2022,2,"2031329","1925952","105377","5.47"
"tamil-nadu",2024,4,"820423888","778536701","41887187","5.38"
"kerala",2023,4,"179843093","170658651","9184442","5.38"
"mizoram",2022,4,"693774","659038","34736","5.27"
"puducherry",2023,4,"12986163","12379641","606522","4.90"
"himachal-pradesh",2021,1,"7614029","7272328","341701","4.70"
"goa",2024,1,"35013987","33460978","1553009","4.64"
"chandigarh",2024,4,"18528444","17708385","820059","4.63"
"jharkhand",2024,3,"522575883","499685871","22890012","4.58"
"uttarakhand",2024,1,"123234577","118071440","5163137","4.37"
"andaman-&-nicobar-islands",2019,4,"35159","33770","1389","4.11"
"manipur",2022,3,"6352742","6105632","247110","4.05"
"goa",2019,2,"768441","738812","29629","4.01"
"uttar-pradesh",2020,2,"100851965","97239132","3612833","3.72"
"bihar",2020,1,"45081815","43530314","1551501","3.56"
"puducherry",2024,1,"13446950","12986163","460787","3.55"
"kerala",2020,2,"16287967","15733522","554445","3.52"
"puducherry",2024,4,"16559677","16008711","550966","3.44"
"uttarakhand",2023,3,"106284687","102758214","3526473","3.43"
"sikkim",2022,3,"2396758","2322081","74677","3.22"
"bihar",2024,3,"1352876223","1313888385","38987838","2.97"
"haryana",2019,2,"22741816","22135775","606041","2.74"
"uttar-pradesh",2019,2,"58883500","57324504","1558996","2.72"
"mizoram",2022,3,"659038","643977","15061","2.34"
"himachal-pradesh",2024,1,"39520561","38651839","868722","2.25"
"mizoram",2021,1,"329575","322607","6968","2.16"
"uttarakhand",2023,1,"79385675","77983880","1401795","1.80"
"goa",2023,3,"26999728","26530590","469138","1.77"
"chandigarh",2023,4,"13280078","13052165","227913","1.75"
"karnataka",2021,2,"530649046","523797492","6851554","1.31"
"andhra-pradesh",2021,1,"289747970","286118552","3629418","1.27"
"delhi",2020,1,"81747604","80744997","1002607","1.24"
"manipur",2022,4,"6428670","6352742","75928","1.20"
"sikkim",2023,4,"4857324","4804937","52387","1.09"
"kerala",2024,1,"181463966","179843093","1620873","0.90"
"manipur",2024,4,"5750423","5700096","50327","0.88"
"uttarakhand",2024,3,"159278815","158564982","713833","0.45"
"andaman-&-nicobar-islands",2019,3,"33770","33689","81","0.24"
"punjab",2024,1,"142537179","142228995","308184","0.22"
"gujarat",2020,2,"47420185","47326417","93768","0.20"
"jharkhand",2020,1,"18282713","18248618","34095","0.19"
"ladakh",2022,1,"630015","630187","-172","-0.03"
"rajasthan",2020,2,"101954656","102258812","-304156","-0.30"
"tamil-nadu",2019,2,"32171737","32275045","-103308","-0.32"
"goa",2024,3,"36762111","37000806","-238695","-0.65"
"meghalaya",2021,1,"747646","754008","-6362","-0.84"
"uttarakhand",2020,2,"9047770","9131784","-84014","-0.92"
"chandigarh",2024,1,"13155173","13280078","-124905","-0.94"
"west-bengal",2019,2,"47023535","47626388","-602853","-1.27"
"andhra-pradesh",2019,2,"56409015","57264522","-855507","-1.49"
"chandigarh",2019,2,"1252470","1274476","-22006","-1.73"
"sikkim",2020,2,"517731","528118","-10387","-1.97"
"arunachal-pradesh",2021,1,"1177456","1209129","-31673","-2.62"
"manipur",2019,2,"257425","265409","-7984","-3.01"
"jammu-&-kashmir",2022,1,"16245311","16790628","-545317","-3.25"
"lakshadweep",2018,4,"1642","1703","-61","-3.58"
"chhattisgarh",2020,2,"18820925","19523991","-703066","-3.60"
"madhya-pradesh",2020,2,"76340573","79366746","-3026173","-3.81"
"andhra-pradesh",2022,3,"642855035","671134030","-28278995","-4.21"
"himachal-pradesh",2023,1,"27301726","28555136","-1253410","-4.39"
"himachal-pradesh",2023,3,"33337054","35061595","-1724541","-4.92"
"haryana",2020,2,"41781050","44036087","-2255037","-5.12"
"ladakh",2024,1,"2987101","3150218","-163117","-5.18"
"jammu-&-kashmir",2022,3,"22534394","23813747","-1279353","-5.37"
"himachal-pradesh",2024,3,"49737549","52583801","-2846252","-5.41"
"meghalaya",2020,3,"597579","635395","-37816","-5.95"
"nagaland",2022,3,"1894113","2031329","-137216","-6.75"
"odisha",2020,2,"50028576","53682307","-3653731","-6.81"
"karnataka",2022,3,"1189761328","1277448960","-87687632","-6.86"
"goa",2022,3,"13188687","14216054","-1027367","-7.23"
"punjab",2020,2,"14081294","15217784","-1136490","-7.47"
"ladakh",2019,4,"84706","92396","-7690","-8.32"
"tripura",2019,2,"532558","580926","-48368","-8.33"
"tripura",2021,1,"1511423","1651890","-140467","-8.50"
"ladakh",2022,4,"1083372","1190858","-107486","-9.03"
"meghalaya",2022,4,"3932448","4359165","-426717","-9.79"
"goa",2021,2,"4710135","5331549","-621414","-11.66"
"west-bengal",2020,2,"57676797","66250381","-8573584","-12.94"
"ladakh",2023,4,"3150218","3621366","-471148","-13.01"
"uttarakhand",2019,2,"4813275","5546001","-732726","-13.21"
"lakshadweep",2022,3,"15241","17569","-2328","-13.25"
"odisha",2019,2,"29512024","34031942","-4519918","-13.28"
"puducherry",2020,2,"1033383","1207921","-174538","-14.45"
"ladakh",2021,1,"275415","332134","-56719","-17.08"
"ladakh",2024,4,"5711284","6913885","-1202601","-17.39"
"odisha",2020,1,"53682307","64995633","-11313326","-17.41"
"madhya-pradesh",2023,1,"734566970","898828268","-164261298","-18.28"
"puducherry",2022,3,"7042727","8643687","-1600960","-18.52"
"delhi",2020,2,"66042018","81747604","-15705586","-19.21"
"lakshadweep",2018,3,"1703","2132","-429","-20.12"
"delhi",2023,1,"409753103","515203457","-105450354","-20.47"
"telangana",2023,1,"1440331458","1819506832","-379175374","-20.84"
"goa",2020,2,"1482092","1881237","-399145","-21.22"
"karnataka",2020,2,"213221712","271033890","-57812178","-21.33"
"lakshadweep",2021,1,"9085","11650","-2565","-22.02"
"tamil-nadu",2020,2,"51870110","66953473","-15083363","-22.53"
"jharkhand",2018,4,"6284043","8122621","-1838578","-22.64"
"maharashtra",2020,2,"184790761","238944081","-54153320","-22.66"
"telangana",2020,2,"152055143","199409525","-47354382","-23.75"
"dadra-&-nagar-haveli-&-daman-&-diu",2019,2,"489656","661814","-172158","-26.01"
"odisha",2018,4,"21142798","30052155","-8909357","-29.65"
"sikkim",2020,1,"528118","767070","-238952","-31.15"
"west-bengal",2020,1,"66250381","96805838","-30555457","-31.56"
"west-bengal",2018,4,"36513548","53705416","-17191868","-32.01"
"chandigarh",2020,2,"1528010","2262511","-734501","-32.46"
"jammu-&-kashmir",2019,2,"2296355","3584987","-1288632","-35.95"
"chandigarh",2023,1,"9815605","17904840","-8089235","-45.18"
"manipur",2023,3,"865478","1606271","-740793","-46.12"
"manipur",2023,1,"3258383","6428670","-3170287","-49.31"
"manipur",2023,2,"1606271","3258383","-1652112","-50.70"
"jammu-&-kashmir",2019,3,"1116526","2296355","-1179829","-51.38"
"jammu-&-kashmir",2019,4,"489928","1116526","-626598","-56.12"
NULL,2020,3,"2033056073",NULL,NULL,NULL
"haryana",2018,1,"4480770",NULL,NULL,NULL
NULL,2020,2,"1448611440",NULL,NULL,NULL
"punjab",2018,1,"1870433",NULL,NULL,NULL
NULL,2024,3,"25821015384",NULL,NULL,NULL
"jharkhand",2018,1,"2178921",NULL,NULL,NULL
NULL,2019,4,"1460445524",NULL,NULL,NULL
"dadra-&-nagar-haveli-&-daman-&-diu",2018,1,"148549",NULL,NULL,NULL
"andaman-&-nicobar-islands",2018,1,"6658",NULL,NULL,NULL
NULL,2023,2,"15109626850",NULL,NULL,NULL
"tripura",2018,1,"148157",NULL,NULL,NULL
"telangana",2018,1,"8522766",NULL,NULL,NULL
NULL,2019,2,"815383203",NULL,NULL,NULL
NULL,2021,4,"6625756346",NULL,NULL,NULL
NULL,2019,1,"708996141",NULL,NULL,NULL
"odisha",2018,1,"5809821",NULL,NULL,NULL
NULL,2023,4,"19015339873",NULL,NULL,NULL
"himachal-pradesh",2018,1,"481918",NULL,NULL,NULL
NULL,2023,3,"17041796123",NULL,NULL,NULL
"manipur",2018,1,"84069",NULL,NULL,NULL
NULL,2024,4,"28219255839",NULL,NULL,NULL
NULL,2022,2,"9131611338",NULL,NULL,NULL
NULL,2019,3,"1095011649",NULL,NULL,NULL
"chhattisgarh",2018,1,"1891514",NULL,NULL,NULL
"tamil-nadu",2018,1,"6726622",NULL,NULL,NULL
"rajasthan",2018,1,"7591690",NULL,NULL,NULL
"madhya-pradesh",2018,1,"8025395",NULL,NULL,NULL
"bihar",2018,1,"5824302",NULL,NULL,NULL
"gujarat",2018,1,"5948775",NULL,NULL,NULL
"ladakh",2018,1,"6089",NULL,NULL,NULL
NULL,2022,4,"12031235819",NULL,NULL,NULL
NULL,2018,1,"134426176",NULL,NULL,NULL
"mizoram",2018,1,"18561",NULL,NULL,NULL
"assam",2018,1,"1056881",NULL,NULL,NULL
"sikkim",2018,1,"44078",NULL,NULL,NULL
"maharashtra",2018,1,"16387034",NULL,NULL,NULL
NULL,2024,1,"21237137569",NULL,NULL,NULL
NULL,2021,1,"3457595131",NULL,NULL,NULL
NULL,2018,2,"187366240",NULL,NULL,NULL
"delhi",2018,1,"7122754",NULL,NULL,NULL
"uttarakhand",2018,1,"1246685",NULL,NULL,NULL
"kerala",2018,1,"1771380",NULL,NULL,NULL
NULL,2022,1,"7593204069",NULL,NULL,NULL
"chandigarh",2018,1,"381895",NULL,NULL,NULL
"goa",2018,1,"160897",NULL,NULL,NULL
"meghalaya",2018,1,"49571",NULL,NULL,NULL
NULL,2020,4,"2869285838",NULL,NULL,NULL
"nagaland",2018,1,"42845",NULL,NULL,NULL
NULL,2020,1,"1623040112",NULL,NULL,NULL
"andhra-pradesh",2018,1,"9039585",NULL,NULL,NULL
"arunachal-pradesh",2018,1,"45497",NULL,NULL,NULL
NULL,2021,3,"5263754525",NULL,NULL,NULL
"karnataka",2018,1,"12016899",NULL,NULL,NULL
NULL,2023,1,"13090574860",NULL,NULL,NULL
"west-bengal",2018,1,"11710225",NULL,NULL,NULL
"lakshadweep",2018,1,"778",NULL,NULL,NULL
NULL,2018,3,"341301189",NULL,NULL,NULL
NULL,2024,2,"24026205526",NULL,NULL,NULL
NULL,2022,3,"10545375100",NULL,NULL,NULL
"jammu-&-kashmir",2018,1,"941568",NULL,NULL,NULL
"uttar-pradesh",2018,1,"12537805",NULL,NULL,NULL
"puducherry",2018,1,"104212",NULL,NULL,NULL
NULL,2021,2,"3941383294",NULL,NULL,NULL
NULL,2018,4,"417113340",NULL,NULL,NULL
